PTR2: ユニットデータ
ユニットデータ
0x01000000
POINTER1: 0
PTR1: 0
PTR2: セリス
セリス
0xD1000000
0x02050100
0x01040009
0x1654EBFF
0x00000000
0x00000000
0x00000000
プレイヤー援軍
ソードマスター男
0x02002B16
0x0B171C19
0x130C3D00
0x00000000
0x00000000
0x00000000
0x00000000
0x00000000
0x00000000
予約０６
回避＋１０
カリスマ
0x00000000
0x00000000
